NO            ./textures/AnyConv.com__BRICK_4A.xpm
SO       ./textures/AnyConv.com__SAND_1A.xpm
WE                     ./textures/AnyConv.com__STEEL_1A.xpm
F                255,0,0
EA                        ./textures/AnyConv.com__TECH_4E.xpm

C             0,0,255


111111111
100000001
10N000001
100000001
111111111